6 8
  ####
 ##PO#
 #OXX#
##.X.#
#.O#.#
#....#
#..###
####