15 12
	#######
####### #.....#
#.....# #.....#
#.X.X.# #....##
#.XX..###.##.#
#..XX.#OOOO#.#
#.X#..#OOOO#.#
#..#.###X###.##
#.X.X.XOOO.#X.#
#..#X.#OOOX...#
#..#P.######..#
#######    ####