18 12
	 #####
##########...#
#........#...#
#..X.X.X.#...#
#.X.X.X.X#...#####
#..X.X.X.#...#OOO#
#.X.XPX.X#...#OOO#
#..X.X.X.#OOO.OOO#
#.X.X.X.X#OOO#OOO#
#..X.X.X..OOO#...#
#........#OOO....#
##################