18 12
	      ####
###############..#
#..OxOOO#PX.X....#
#..#OOOO#XX.X..X.#
#..#OOOO#..X..X..#
#..#OOOxX.XXX.XX.#
#.X#OOOO#.....XO.#
#..#OxOO#.X.X..x.#
#..OX.X.#######.##
#..#....X.X.X.X.#
########........#
       ##########