17 11
#############
#..#.OOOX...#
#.X#.OOOX...#####
#..#.X.X.X.X....#
#.X##.###P#.#...#
#...#OOO###X#####
#.X.#OOO..#O..#
#..X##X.#X#O#.#
#...X.....XO..#
#####..########
    ####