19 12
  #########
  #OOOOOOO########
  #OOOOOOO...#...##
#######...#X.#.XX.#
#.X......X...#....#
#.X##..#.###.#.XX##
#...XX.#OOO#.#...#
#....X.#OOO#X#.XX#
#.XXX..#OxO..X...#
#..XPX.##X#X.#...#
######......######
     ########