15 12
#############
#...........#
#.XX.X.X.X..###
#..X########..#
#...#OOOOOOOX.#
#.#XXOOOOOO#..#
#P..#.##.###.##
###.#..#......#
#....X.#...X..#
#.#X#X.###....#
#...#..# ######
########