17 10
     ##########
  ####....#...###
  #..#.XX.#.....#
  #X.#...X#.....#
###..#..X.#.....#
#...X#X..X#xO####
#...X...X.#OOOOO#
#.XXX#.XPX.OxOOO#
#....#....#OOOOO#
#################