19 12
     #############
######...OOOO#...##
#....#.X.xOOO#.X..#
#..X.##.#OOOO#.X#.#
#..X..#.#OOOx#.X.P#
#.XXX.#.####.#OO###
#..#..#X.X.#..OO#
#.X#X.#.X..Ox##.##
#..#.X#.#.Xxx.#..#
#.X#.....X.....X.#
#.....#..######..#
##########    ####