11 11
###########
#........P#
#.#X.X.X..#
#.#.XXXX..#
#.#X.X.X..#
#.#.....X.#
#.#X###.###
#.#.#OOOOO#
#.#.#O...O#
#....OOOOO#
###########