16 11
################
#.......#OOQ#..#
#.X.XXX.#Oxx...#
#..#...###..#OO#
#.X##....X.##Ox#
#.....#.X..#.OO#
#.X##X#..X##...#
#..#..#.X.#....#
#.X#...x#O#...X#
#..####OOO.....#
####  ##########