16 12
  ##############
  #.....#......#
  #.XX...xxx#..#
  #..X..#xOx.X.#
  #.#O#.#OOO#..#
  #.#x..#.X.#X.#
  #.#O#X#..X#..#
  #.....#...#X.#
#####XX######..#
#...#OOxOOX.XX.#
#.X..OOOOO#...P#
################