12 11
########
#.O.#..#####
#.OX#.X#...#
##O.#...OOO#
 #.X#.X#####
 #..#..#
 #.X#.X#
 #.....#
 #P.#..#
 #..#..#
 #######