19 12
     ############
     #..........##
     #...........#
#######.#######..#
#P.....XX.#...#OO#
#...X.XX..#X...OO#
#..X.XX.X.#...#..#
##X.XX.X..#X####.##
#..XX.X...#OOO#OO.#
#..X.X.X..#OOOOOO.#
#.......#..OOOOOO.#
###################