11 8
 ########
 #.P#...#
 #.X..X.#
 #X.#######
##.X#.....#
#O.O.O....#
#O..#######
#####