12 10
 ###########
 #.........#
 #..X.####X#
##.####OOOO#
#..X..#OOOO#
#..XX.#OO..#
##.PX.###..#
 #.XX..X.X.#
 #......#..#
 ###########