14 10
   ####  ####
####..####..##
#.X....#..X..#
#.O#O#OX.#...#
#.XxOO#..#XX##
#..###OOO.X..#
#.X.XOOOO#X..#
#..#XX#..#...#
#P....########
#######