7 8
#######
#.....#
#.X.X.#
#.X.XP#
#.XX.##
#..OOO#
###OOO#
  #####