18 11
#######
#.....############
##X#..X.X..#OOOOO#
#..#X.#.....OOOOO#
#..#.....X.####..#
#..#O##X#.##..##X#
#.X#OX.X...#.....#
#.X.OX.P####XX...#
####OX.XOOOO.X.X.#
   ###..##########
     ####