19 9
######         ####
#....########  #..#
#.xxx.X.X.X.#  #..#
#.O#O#X.....#  #X.#
#.QxO#......####..#
#.#XO.X##X###.X...#
#.OxO...X.........#
#.OOO########..####
######      ####