13 11
 #####
 #O..#
 #.XP#
 #O.##
###.#########
#.X.X.X.X...#
#......X....#
#.#######.###
#O...X...OO#
########.OO#
       #####