10 7
#########
#...#P..#
#.#.#..X##
#...X....#
##.X.#.#.#
#OOO##...#
##########