19 12
     ##############
     #..OOOOxP#...#
     #..#OOxOX..X.#
     #.X#OOOx.#####
#######.#OOOOX#...#
#.....#.####X...X.#
#..X.X#.OOO..###.##
#.X.X.#.Ox..X.....#
#..X.X##Ox#########
#.X.XX...X..X..X..#
#.......#.........#
###################