13 12
####
#..##########
#.XX.X.#OOOO#
#......#OOOO#
#...XX#.OOOO#
#.X.P.#...OO#
#.X#####.####
##.#...#X..#
#..#.XX..X.#
#....X.#XX.#
#..#...#...#
############