10 10
##########
#...#....#
#...#..X.#
#.XO#.X..#
#.OOxO####
##X#OxOx.#
#..XO#OX.#
#.X..#.X.#
#....#..P#
##########