13 10
####    #####
#..######...#
#.XX.....X..#
#..######.X.#
##.#OxOx.X..#
#..XOOOO#.X.#
#..#OOOO#XP.#
#.X######.X.#
#...........#
#############