8 8
########
#..#...#
#...X..#
#..#XX.#
##.#...#
#OO.X#.#
#OO...P#
########