11 10
   ########
   #......#
   #...X..#
####.#x#X.#
#OOO.xQOX.#
#Ox#.#x#..#
#O.#.X....#
#.XX....X.#
#..########
####