13 11
#############
#...........#
#.XX.#.#.XX.#
#..XXOOOXX..#
#...##O##...#
#.OxOOOOOxO.#
#..###O###..#
####.XOX.####
   #.XXX.#
   #..P..#
   #######