15 11
 ##############
 #............#
 #..X.X.X.X.X.#
 #.#.X.#####X.#
 #.#X..#OO#OOO#
 #...X.#OO#OxO#
##.#####OO#OO##
#.........##OO#
#.X.X.XPX..XX.#
###########...#
	  #####
