13 12
########
#P....O##
#....#O.#
#.XX.#O.#
#....#OX#
###X##X.#####
#.O.....X...#
#OO#.X.XX...#
#OO####.###.#
#.O....X....#
#..##########
####